1111111111111111
10E0000000000011
110000C000000011
1111111111111011
1000000P00000011
1010000D01000011
10000C0000000011
10000000100C0011
100000C000000011
1111111111101111
100C000000000011
1111111111111111
1001000000000011
1000000000100011
1111111111111111