11111111111111111111111
1C000000000000100C00001
10000000000000000000001
11011100000111100C00001
1E000000000111100000001
1111111100D011100P00001
1C000000000000100000001
10000000000000100000001
11011100000111100000001
100000000000C000000C001
11111111111111111111111